--------------------------------------------------------------------
-0000000000000000000000000000000000000000000000000000000000000005000
-0000000000110000000400111111111111111111111100000000000055000000000
0000000000011000005000000004000550005000011110000-------------------
-0000000000110000000000005000000000000000000000---------------------
-------00004455000000005000400454550005555--------------------------
---000000000000000000000000000--------------------------------------
--------------0005000000400000--------------------------------------
-------------0000000000000000000000000------------------------------
--------------00000000000011100000000000----------------------------
-----------------------00011100000000000000000000000000000000000----
