------------------------------
-00000000000000000000001111---
-000000000011000000000033330--
00000000000220000000000000000-
-0000000000330000000----------
-------0000445500000----------
---0000000000000000-----------
--------------0005000000000000
