11111111111111111111111111--------1111111111111111111111111111
11111111111111111111111111--------1111111111111111111111111111
11000000000000100000000011--------1100000000000000000000000011
11000050055500000000000011--------1100000000000000000000000011
11000000000000000000000011111111111100000045550000000000000011
11111111111111100000000011111111111100000000000000000000000011
11000000000000100000000000044405000000000000000001111111111111
11000000000050100000000000000000000000000000000001111111111111
110000000000000000000000055500000000000000000000011-----------
110000000000050000000000000000000000000000000000011-----------
110000000000000000000000000000000000000000000000011-----------
111111111111111111111111111111111111111111111111111-----------
111111111111111111111111111111111111111111111111111-----------
