------------------------------------------------------------------------------------------------------------------------------------
------------------------------------------------------------------------------------------------------------------------------------
111111111111111111111111111111111111111111111---------------------------------------------------------------------------------------
1111111111111111000000000050000000440000000011--------------------------------------------------------------------------------------
110000000400001100000000000000000000000000000111111111111111111111111111111111111111111111111111111111111111111111111111111111111111
110005500005001100000000000000000000000000000011000000000111111111111111111111111111111111111111111111111111111111111111111111111111
110500050000001100000000000010000000000000000011000055000110000000000000000000000000000550000050000000001100000005000000001111111---
1100000000500010000000000000100000000000000001100000000001100000000000050000000000000050000000000000000011000005000000000011111-----
11500000040000100000000000001000000500000000011000111111111000000000000000004440444111111000000000000000110000050000011111111-------
11000000000000000000000000001000050000000000000050000000000000050000000000000000000111111000000000000000110000001111111-------------
114444454000000000000000000010000000000000000000500000000000000000000000000000000000400555001111111111111100000011111---------------
110000000000000100000000000010000000000000000000000011100000000000000000000400000000000000000000000000000000000011111---------------
111111111111111111111111111110000011111111111111111111100000000000000000000000000000000000000000400040000000000011111---------------
100000000100000000000000000000000000000000000000000000000000000050000000000000000000000000000000000000000000000011111---------------
1000000011000000000004001111111111000000000000550000000001111111111111111111111111111111110000050111111111111111111111111-----------
1110000000000000050000000011111111110000011110000000000001111111111111111111111111111111110000005111111111111111111111111-----------
--11111111000000000000500000000000000000000000000000000000000000000000000000000000000000000000000000000000000000000000111-----------
---------1144550000000050004004545500055550000000000000000000000000000000000000000000000000000000000000000000000000000111-----------
----------111110000000000055000000000000000000000000000000040004000000000000000000040000550500000000005000000000000011111-----------
--------------10050000004000000000000000000000000050000000000000000000000000004000011111111111111111111111111111111111111-----------
--------------10000000000000000000000000000000004000000000000000000000000000000000400000004000555000111111111111111111111-----------
--------------1000000000001110000000000000000000500000004000000000000000000000000000000000000000000000001111111111111111111111111111
--------------1111111111000111000000000000000000000000000000000011111111111111111000000000000000000000000000000000000001111111111111
-----------------------111111111111111111111111111111111111111111--------------11111111111111111115500000000555000000051104000000011
-------------------------------------------------------------------------------------------------11111110000000000000000000000000011
-------------------------------------------------------------------------------------------------------11111111000005005000000000011
--------------------------------------------------------------------------------------------------------------1111111111111111111111
------------------------------------------------------------------------------------------------------------------------------------