------------------------------------------------------------------------------------------------------------------------------------
------------------------------------------------------------------------------------------------------------------------------------
333333333333333333333333333333333333333333333---------------------------------------------------------------------------------------
3333333333333333000000000050000000440000000033--------------------------------------------------------------------------------------
330000000400003300000000000000000000000000000333333333333333333333333333333333333333333333333333333333333333333333333333333333333333
330005500005003300000000000000000000000000000033000000000333333333333333333333333333333333333333333333333333333333333333333333333333
330500050000003300000000000030000000000000000033000055000330000000000000000000000000000550000050000000003300000005000000003333333---
3300000000500030000000000000300000000000000003300000000003300000000000050000000000000050000000000000000033000005000000000033333-----
33500000040000300000000000003000000500000000033000333333333000000000000000004440444333333000000000000000330000050000033333333-------
33000000000000000000000000003000050000000000000050000000000000050000000000000000000111111000000000000000330000003333333-------------
334444454000000000000000000030000000000000000000500000000000000000000000000000000000400555001333333333333300000033333---------------
330000000000000300000000000030000000000000000000000033300000000000000000000400000000000000000000000000000000000033333---------------
333333333333333333333333333330000033333333333333333333300000000000000000000000000000000000000000400040000000000033333---------------
300000000300000000000000000000000000000000000000000000000000000050000000000000000000000000000000000000000000000033333---------------
0000000033000000000004003333333333000000000000550000000003333333333333333333333333333333330000050333333333333333333333333-----------
3300000000300000050000000011111111110000011110000000000003333333333333333333333333333333330000005333333333333333333333333-----------
---0000033000000000000500000000000000000000000000000000000000000000000000000000000000000000000000000000000000000000000333-----------
---------3344550000000050004004545500055550000000000000000000000000000000000000000000000000000000000000000000000000000333-----------
----------333330000000000055000000000000000000000000000000040004000000000000000000040000550500000000005000000000000033333-----------
--------------3005000000400000-000000000000000000050000000000000000000000000004000033333333333333333333333333333333333333-----------
--------------30000000000000000000000000000000004000000000000000000000000000000000400000004000555000333333333333333333333-----------
--------------30000000000011100000000000000000005000000040000000000000000000000000000000000000000000000033333333333333333333333333333
--------------33333333330001110000000000000000000000000000000000333333333333333330000000000000000000000000000000000000033333333333333
-----------------------333333333333333333333333333333333333333333--------------333333333333333333355000000005550000000533040000000033
-------------------------------------------------------------------------------------------------333333300000000000000000000000000033
-------------------------------------------------------------------------------------------------------333333330000050050000000000033
--------------------------------------------------------------------------------------------------------------33333333333333333333333
-------------------------------------------------------------------------------------------------------------------------------------